555555557888955
578889554555195
545551883555565
545555555555565
512222957889565
555555454556565
788888354556519
455555551223556
455555555555556
122222222295556
555555555512223